custom random 2 size 10 crystals 1
----------
-------X--
----C--o--
----o--o--
----o--o--
-ooooooo--
-o--o-----
-o--o-----
-s--------
----------

----------
-------X--
-------o--
----o--o--
----o--o--
-ooooooo--
-o--o-----
-o--o-----
-s--C-----
----------