----------
----------
----oooo--
----o--o--
----o--o--
-oooo--o--
-o-----o--
-o-----X--
-s--------
----------