----------
-s--------
-o-oooo---
-o-o--o---
-ooo--o---
------o---
------o---
------o---
------X---
----------