----------
---C----s-
---o----o-
---o----o-
---oooooo-
---o------
---ooooC--
---o------
---ooX----
----------