custom random 4 size 10
----------
-------X--
-------o--
----oooo--
----o-----
----o-----
----oooo--
-------o--
-------s--
----------

----------
-X--------
-o--------
-oooo-----
----o-----
----o-----
----oooo--
-------o--
-------s--
----------

----------
-------X--
-------o--
----oooo--
----o-----
----o-----
-oooo-----
-o--------
-s--------
----------

----------
-X--------
-o--------
-oooo-----
----o-----
----o-----
-oooo-----
-o--------
-s--------
----------