------X---
------o---
------o---
---oooo---
---o------
---o------
---o------
---ooo----
-----o----
-----s----