s---------
o---------
o---------
ooo-------
--o-------
--ooo-----
----o-----
----ooo---
------o---
------X---